6,2,2,2,2,2,2,2,2,2,2,2,2,2,7
6,4,4,4,4,4,4,4,4,4,4,4,3,4,7
5,0,0,0,0,0,0,0,0,0,0,0,0,0,8
5,0,0,1,1,1,1,1,1,1,1,0,0,0,8
5,0,0,0,0,0,0,0,0,0,0,0,0,0,8
5,0,0,1,1,1,1,1,1,1,1,0,0,0,8
5,0,0,0,0,0,0,0,0,0,0,0,0,0,8
5,0,1,1,1,0,1,1,1,0,1,1,1,0,8
5,0,0,0,0,0,0,0,0,0,0,0,0,0,8
5,0,0,0,0,0,0,0,0,0,0,0,0,0,8
5,0,0,0,0,0,0,0,0,0,0,0,0,0,8
5,0,0,0,0,0,0,0,0,0,0,0,0,0,8
5,0,0,0,0,0,0,0,0,0,0,0,0,0,8
5,0,0,0,0,0,0,0,0,0,0,0,0,0,8
5,0,0,0,0,0,0,0,0,0,0,0,0,0,8